2, _, _, 1, _
_, 5, 4, 2, _
3, _, _, 2, 1
4, _, _, _, 1
_, _, _, 2, 1