1,_,2,3,_,2
2,2,3,_,_,2
_,_,_,4,4,2
_,3,_,_,_,_
1,2,2,_,3,_
_,_,_,_,3,_
